#########
#...B...#
#...r...#
#..b....#
#.......#
#...R...#
#.......#
#.b...B.#
#########
