####R###
#....###
#.b....#
#.r....#
#......B
#......#
########
