#########
#####...#
####.rb.#
###.....R
#...g...#
#.......#
#.......#
##B##G###
